#############################
#oooooooooooo #oooooooooooo #
#O          I #           O #
#o ###B ####  #  ####  ###  #
#o ###  ####  #  ####  ###  #
#o P                        #
#o                          #
#o ###  #                   #
#O @    #                   #
#       #                   #
#############################
     
